Chr,Start,Stop,Region,Coverage,CoverageRead1,CoverageRead2,GeneIDs
chr1,43814944,43815111,CHP2_MPL_1.1,1336,721,615,MPL
chr1,115252161,115252294,CHP2_NRAS_3.1,2589,1299,1290,NRAS
chr1,115256480,115256609,CHP2_NRAS_2.1,1661,830,831,NRAS
chr1,115258665,115258799,CHP2_NRAS_1.1,2356,1186,1170,NRAS
chr2,29432548,29432705,CHP2_ALK_2.1,1270,640,630,ALK
chr2,29443583,29443754,CHP2_ALK_1.1,2436,1236,1200,ALK
chr2,209113079,209113231,CHP2_IDH1_1.1,2891,1445,1446,IDH1
chr2,212288880,212289015,CHP2_ERBB4_8.1,3080,1549,1531,ERBB4
chr2,212530027,212530205,CHP2_ERBB4_7.1,881,444,437,ERBB4
chr2,212576775,212576935,CHP2_ERBB4_6.1,4799,2406,2393,ERBB4
chr2,212578264,212578440,CHP2_ERBB4_5.1,3345,1680,1665,ERBB4
chr2,212587109,212587264,CHP2_ERBB4_4.1,2773,1393,1380,ERBB4
chr2,212589740,212589892,CHP2_ERBB4_3.1,992,501,491,ERBB4
chr2,212652695,212652831,CHP2_ERBB4_2.1,4378,2202,2176,ERBB4
chr2,212812051,212812194,CHP2_ERBB4_1.1,3261,1640,1621,ERBB4
chr3,10183741,10183879,CHP2_VHL_1.1,1101,564,537,VHL
chr3,10188162,10188331,CHP2_VHL_2.1,5254,2653,2601,VHL
chr3,10191394,10191552,CHP2_VHL_3.1,7083,3560,3523,VHL
chr3,37067183,37067358,CHP2_MLH1_1.1,3802,1908,1894,MLH1
chr3,41266005,41266172,CHP2_CTNNB1_1.1,1422,720,702,CTNNB1
chr3,178916751,178916906,CHP2_PIK3CA_1.1,3054,1531,1523,PIK3CA
chr3,178916907,178917060,CHP2_PIK3CA_2.1,2105,1055,1050,PIK3CA
chr3,178921440,178921595,CHP2_PIK3CA_3.1,3721,1866,1855,PIK3CA
chr3,178927381,178927550,CHP2_PIK3CA_4.1,2079,1045,1034,PIK3CA
chr3,178927877,178928011,CHP2_PIK3CA_5.1,1428,714,714,PIK3CA
chr3,178928045,178928185,CHP2_PIK3CA_6.1,1873,940,933,PIK3CA
chr3,178935999,178936130,CHP2_PIK3CA_7.1,4139,2069,2070,PIK3CA
chr3,178938763,178938943,CHP2_PIK3CA_8.1,2306,1162,1144,PIK3CA
chr3,178947794,178947921,CHP2_PIK3CA_9.1,5781,2899,2882,PIK3CA
chr3,178951972,178952122,CHP2_PIK3CA_10.1,2797,1401,1396,PIK3CA
chr3,178952116,178952262,CHP2_PIK3CA_11.1,3371,1692,1679,PIK3CA
chr4,1803527,1803678,CHP2_FGFR3_1.1,811,491,320,FGFR3
chr4,1806057,1806212,CHP2_FGFR3_2.1,443,227,216,FGFR3
chr4,1807809,1807955,CHP2_FGFR3_3.1,1479,751,728,FGFR3
chr4,1808287,1808424,CHP2_FGFR3_4.1,2484,1250,1234,FGFR3
chr4,1808857,1809031,CHP2_FGFR3_5.1,2082,1052,1030,FGFR3
chr4,55140957,55141128,CHP2_PDGFRA_1.1,1775,891,884,PDGFRA
chr4,55144077,55144220,CHP2_PDGFRA_2.1,3375,1696,1679,PDGFRA
chr4,55144514,55144678,CHP2_PDGFRA_3.1,2374,1192,1182,PDGFRA
chr4,55152000,55152179,CHP2_PDGFRA_4.1,3104,1557,1547,PDGFRA
chr4,55561630,55561809,CHP2_KIT_1.1,2464,1233,1231,KIT
chr4,55592133,55592271,CHP2_KIT_2.1,3213,1608,1605,KIT
chr4,55593393,55593538,CHP2_KIT_3.1,2496,1254,1242,KIT
chr4,55593551,55593720,CHP2_KIT_4.1,3834,1922,1912,KIT
chr4,55594146,55594304,CHP2_KIT_5.1,2038,1021,1017,KIT
chr4,55595472,55595587,CHP2_KIT_6.1,4389,2205,2184,KIT
chr4,55597412,55597549,CHP2_KIT_7.1,2666,1340,1326,KIT
chr4,55599256,55599383,CHP2_KIT_8.1,3651,1832,1819,KIT
chr4,55602649,55602776,CHP2_KIT_9.1,4173,2096,2077,KIT
chr4,55946064,55946233,CHP2_KDR_9.1,1698,860,838,KDR
chr4,55946226,55946396,CHP2_KDR_8.1,3590,1808,1782,KDR
chr4,55953751,55953885,CHP2_KDR_7.1,3600,1807,1793,KDR
chr4,55955054,55955193,CHP2_KDR_6.1,4537,2281,2256,KDR
chr4,55960952,55961084,CHP2_KDR_5.1,5419,2725,2694,KDR
chr4,55962420,55962573,CHP2_KDR_4.1,3205,1612,1593,KDR
chr4,55972928,55973096,CHP2_KDR_3.1,1220,616,604,KDR
chr4,55979550,55979680,CHP2_KDR_2.1,939,473,466,KDR
chr4,55980214,55980384,CHP2_KDR_1.1,2448,1229,1219,KDR
chr4,153245386,153245517,CHP2_FBXW7_5.1,3365,1691,1674,FBXW7
chr4,153247253,153247394,CHP2_FBXW7_4.1,2944,1486,1458,FBXW7
chr4,153249331,153249502,CHP2_FBXW7_3.1,2476,1239,1237,FBXW7
chr4,153250828,153250951,CHP2_FBXW7_2.1,3231,1629,1602,FBXW7
chr4,153258877,153259048,CHP2_FBXW7_1.1,2444,1231,1213,FBXW7
chr5,112173847,112173987,CHP2_APC_1.1,2586,1295,1291,APC
chr5,112174533,112174691,CHP2_APC_2.1,2693,1361,1332,APC
chr5,112175119,112175293,CHP2_APC_3.1,2721,1368,1353,APC
chr5,112175291,112175468,CHP2_APC_4.1,2977,1501,1476,APC
chr5,112175543,112175728,CHP2_APC_5.1,1360,688,672,APC
chr5,112175716,112175887,CHP2_APC_6.1,3489,1752,1737,APC
chr5,112175896,112176060,CHP2_APC_7.1,1297,652,645,APC
chr5,149433569,149433717,CHP2_CSF1R_2.1,886,444,442,CSF1R
chr5,149452967,149453098,CHP2_CSF1R_1.1,2073,1038,1035,CSF1R
chr5,170837477,170837641,CHP2_NPM1_1.1,2672,1344,1328,NPM1
chr7,55211020,55211151,CHP2_EGFR_1.1,2511,1261,1250,EGFR
chr7,55221768,55221944,CHP2_EGFR_2.1,2988,1504,1484,EGFR
chr7,55232938,55233078,CHP2_EGFR_3.1,5428,2724,2704,EGFR
chr7,55241611,55241754,CHP2_EGFR_4.1,1456,730,726,EGFR
chr7,55242387,55242565,CHP2_EGFR_5.1,3022,1520,1502,EGFR
chr7,55248941,55249115,CHP2_EGFR_6.1,2016,1019,997,EGFR
chr7,55249098,55249270,CHP2_EGFR_7.1,3263,1638,1625,EGFR
chr7,55259483,55259653,CHP2_EGFR_8.1,3051,1528,1523,EGFR
chr7,116339591,116339726,CHP2_MET_1.1,3481,1751,1730,MET
chr7,116340131,116340295,CHP2_MET_2.1,1745,880,865,MET
chr7,116403107,116403276,CHP2_MET_3.1,1621,812,809,MET
chr7,116411854,116412022,CHP2_MET_4.1,2602,1314,1288,MET
chr7,116417403,116417567,CHP2_MET_5.1,2337,1176,1161,MET
chr7,116423383,116423517,CHP2_MET_6.1,1769,890,879,MET
chr7,128845039,128845213,CHP2_SMO_1.1,2871,1446,1425,SMO
chr7,128845933,128846088,CHP2_SMO_2.1,1303,658,645,SMO
chr7,128846313,128846444,CHP2_SMO_3.1,1704,857,847,SMO
chr7,128850245,128850388,CHP2_SMO_4.1,1500,753,747,SMO
chr7,128851475,128851637,CHP2_SMO_5.1,1899,955,944,SMO
chr7,140453078,140453246,CHP2_BRAF_2.1,2324,1164,1160,BRAF
chr7,140481367,140481540,CHP2_BRAF_1.1,2461,1242,1219,BRAF
chr7,148508682,148508816,CHP2_EZH2_1.1,2324,1165,1159,EZH2
chr8,38282116,38282279,CHP2_FGFR1_2.1,3072,1548,1524,FGFR1
chr8,38285827,38286000,CHP2_FGFR1_1.1,1912,964,948,FGFR1
chr9,5073705,5073882,CHP2_JAK2_1.1,1915,960,955,JAK2
chr9,21970916,21971091,CHP2_CDKN2A_2.1,788,402,386,CDKN2A
chr9,21971066,21971244,CHP2_CDKN2A_1.1,973,550,423,CDKN2A
chr9,80409351,80409523,CHP2_GNAQ_1.1,1874,942,932,GNAQ
chr9,133738270,133738403,CHP2_ABL1_1.1,5036,2529,2507,ABL1
chr9,133747418,133747555,CHP2_ABL1_2.1,3902,1957,1945,ABL1
chr9,133748255,133748442,CHP2_ABL1_3.1,2792,1403,1389,ABL1
chr9,133750283,133750430,CHP2_ABL1_4.1,1822,915,907,ABL1
chr9,139390740,139390910,CHP2_NOTCH1_3.1,1129,569,560,NOTCH1
chr9,139397738,139397904,CHP2_NOTCH1_2.1,2808,1413,1395,NOTCH1
chr9,139399313,139399472,CHP2_NOTCH1_1.1,633,321,312,NOTCH1
chr10,43609042,43609207,CHP2_RET_1.1,2871,1444,1427,RET
chr10,43609850,43610035,CHP2_RET_2.1,1151,580,571,RET
chr10,43613770,43613918,CHP2_RET_3.1,2434,1231,1203,RET
chr10,43615522,43615712,CHP2_RET_4.1,1858,941,917,RET
chr10,43617290,43617458,CHP2_RET_5.1,2737,1375,1362,RET
chr10,89624183,89624325,CHP2_PTEN_1.1,1431,721,710,PTEN
chr10,89685234,89685399,CHP2_PTEN_2.1,3942,1988,1954,PTEN
chr10,89692789,89692945,CHP2_PTEN_3.1,2619,1317,1302,PTEN
chr10,89711780,89711957,CHP2_PTEN_4.1,2257,1136,1121,PTEN
chr10,89717479,89717645,CHP2_PTEN_5.1,3208,1609,1599,PTEN
chr10,89717642,89717805,CHP2_PTEN_6.1,2995,1502,1493,PTEN
chr10,89720671,89720772,CHP2_PTEN_7.1,7609,3815,3794,PTEN
chr10,89720760,89720925,CHP2_PTEN_8.1,3098,1559,1539,PTEN
chr10,123257928,123258070,CHP2_FGFR2_4.1,3460,1737,1723,FGFR2
chr10,123274697,123274860,CHP2_FGFR2_3.1,1188,595,593,FGFR2
chr10,123279393,123279569,CHP2_FGFR2_2.1,3852,1931,1921,FGFR2
chr10,123279583,123279738,CHP2_FGFR2_1.1,2743,1381,1362,FGFR2
chr11,533788,533955,CHP2_HRAS_2.1,677,340,337,HRAS
chr11,534196,534333,CHP2_HRAS_1.1,618,317,301,HRAS
chr11,108117741,108117890,CHP2_ATM_1.1,2300,1156,1144,ATM
chr11,108119791,108119916,CHP2_ATM_2.1,3485,1750,1735,ATM
chr11,108123491,108123643,CHP2_ATM_3.1,2911,1457,1454,ATM
chr11,108137907,108138050,CHP2_ATM_4.1,2404,1205,1199,ATM
chr11,108155059,108155205,CHP2_ATM_5.1,2511,1271,1240,ATM
chr11,108170432,108170581,CHP2_ATM_6.1,2212,1114,1098,ATM
chr11,108172338,108172492,CHP2_ATM_7.1,3133,1578,1555,ATM
chr11,108173606,108173728,CHP2_ATM_8.1,3615,1815,1800,ATM
chr11,108180878,108180985,CHP2_ATM_9.1,1883,943,940,ATM
chr11,108200891,108201018,CHP2_ATM_10.1,2102,1057,1045,ATM
chr11,108204610,108204709,CHP2_ATM_11.1,3747,1886,1861,ATM
chr11,108205707,108205841,CHP2_ATM_12.1,3411,1710,1701,ATM
chr11,108206499,108206653,CHP2_ATM_13.1,2830,1430,1400,ATM
chr11,108217991,108218169,CHP2_ATM_14.1,2061,1034,1027,ATM
chr11,108225525,108225657,CHP2_ATM_15.1,2371,1189,1182,ATM
chr11,108236018,108236165,CHP2_ATM_16.1,1714,862,852,ATM
chr11,108236162,108236310,CHP2_ATM_17.1,1015,507,508,ATM
chr12,25378525,25378683,CHP2_KRAS_3.1,3780,1894,1886,KRAS
chr12,25380236,25380389,CHP2_KRAS_2.1,3280,1650,1630,KRAS
chr12,25398162,25398329,CHP2_KRAS_1.1,2897,1459,1438,KRAS
chr12,112888094,112888253,CHP2_PTPN11_1.1,3169,1594,1575,PTPN11
chr12,112926811,112926986,CHP2_PTPN11_2.1,3260,1643,1617,PTPN11
chr12,121431347,121431484,CHP2_HNF1A_1.1,2490,1250,1240,HNF1A
chr12,121431986,121432124,CHP2_HNF1A_2.1,3601,1812,1789,HNF1A
chr13,28592555,28592688,CHP2_FLT3_4.1,2651,1331,1320,FLT3
chr13,28602251,28602404,CHP2_FLT3_3.1,3157,1590,1567,FLT3
chr13,28608203,28608373,CHP2_FLT3_2.1,2683,1353,1330,FLT3
chr13,28610069,28610209,CHP2_FLT3_1.1,3687,1853,1834,FLT3
chr13,48919199,48919337,CHP2_RB1_1.1,3423,1720,1703,RB1
chr13,48923115,48923280,CHP2_RB1_2.1,2722,1370,1352,RB1
chr13,48941577,48941749,CHP2_RB1_3.1,2639,1324,1315,RB1
chr13,48942573,48942736,CHP2_RB1_4.1,1807,912,895,RB1
chr13,48953729,48953899,CHP2_RB1_5.1,2518,1266,1252,RB1
chr13,48955501,48955630,CHP2_RB1_6.1,4210,2119,2091,RB1
chr13,49027081,49027203,CHP2_RB1_7.1,3600,1814,1786,RB1
chr13,49033803,49033959,CHP2_RB1_8.1,2734,1375,1359,RB1
chr13,49037822,49037957,CHP2_RB1_9.1,4169,2097,2072,RB1
chr13,49039125,49039257,CHP2_RB1_10.1,3152,1583,1569,RB1
chr14,105241409,105241544,CHP2_AKT1_2.1,2517,1263,1254,AKT1
chr14,105246421,105246608,CHP2_AKT1_1.1,1294,659,635,AKT1
chr15,90631800,90631979,CHP2_IDH2_1.1,2266,1140,1126,IDH2
chr16,68835578,68835722,CHP2_CDH1_1.1,4220,2123,2097,CDH1
chr16,68846000,68846176,CHP2_CDH1_2.1,3101,1553,1548,CDH1
chr16,68847175,68847327,CHP2_CDH1_3.1,4291,2157,2134,CDH1
chr17,7573899,7574060,CHP2_TP53_8.1,2029,1017,1012,TP53
chr17,7576991,7577176,CHP2_TP53_7.1,1754,885,869,TP53
chr17,7577484,7577637,CHP2_TP53_6.1,3626,1825,1801,TP53
chr17,7578156,7578323,CHP2_TP53_5.1,2119,1076,1043,TP53
chr17,7578328,7578508,CHP2_TP53_4.1,2835,1424,1411,TP53
chr17,7578492,7578626,CHP2_TP53_3.1,2043,1028,1015,TP53
chr17,7579326,7579510,CHP2_TP53_2.1,1389,711,678,TP53
chr17,7579829,7579985,CHP2_TP53_1.1,3237,1637,1600,TP53
chr17,37880188,37880365,CHP2_ERBB2_1.1,2904,1460,1444,ERBB2
chr17,37880929,37881086,CHP2_ERBB2_2.1,2139,1078,1061,ERBB2
chr17,37881300,37881478,CHP2_ERBB2_3.1,1965,1038,927,ERBB2
chr18,48575075,48575238,CHP2_SMAD4_1.1,1725,863,862,SMAD4
chr18,48575532,48575702,CHP2_SMAD4_2.1,1194,597,597,SMAD4
chr18,48581166,48581327,CHP2_SMAD4_3.1,1399,705,694,SMAD4
chr18,48584527,48584703,CHP2_SMAD4_4.1,1969,985,984,SMAD4
chr18,48586227,48586386,CHP2_SMAD4_5.1,1784,899,885,SMAD4
chr18,48591790,48591956,CHP2_SMAD4_6.1,2040,1022,1018,SMAD4
chr18,48593375,48593544,CHP2_SMAD4_7.1,1029,516,513,SMAD4
chr18,48603004,48603144,CHP2_SMAD4_8.1,2706,1367,1339,SMAD4
chr18,48604634,48604799,CHP2_SMAD4_9.1,1056,533,523,SMAD4
chr19,1206953,1207129,CHP2_STK11_1.1,3595,1808,1787,STK11
chr19,1220286,1220475,CHP2_STK11_2.1,790,397,393,STK11
chr19,1220456,1220628,CHP2_STK11_3.1,1264,740,524,STK11
chr19,1221212,1221357,CHP2_STK11_4.1,2638,1325,1313,STK11
chr19,1222990,1223169,CHP2_STK11_5.1,2471,1248,1223,STK11
chr19,3118857,3118998,CHP2_GNA11_1.1,1216,613,603,GNA11
chr19,17945592,17945759,CHP2_JAK3_3.1,1967,993,974,JAK3
chr19,17947962,17948099,CHP2_JAK3_2.1,1965,992,973,JAK3
chr19,17954110,17954250,CHP2_JAK3_1.1,1946,983,963,JAK3
chr20,36031642,36031794,CHP2_SRC_1.1,3582,1801,1781,SRC
chr20,57484372,57484529,CHP2_GNAS_1.1,1689,850,839,GNAS
chr20,57484538,57484697,CHP2_GNAS_2.1,4203,2114,2089,GNAS
chr22,24133929,24134089,CHP2_SMARCB1_1.1,2589,1305,1284,SMARCB1
chr22,24143176,24143336,CHP2_SMARCB1_2.1,588,295,293,SMARCB1
chr22,24145453,24145623,CHP2_SMARCB1_3.1,3055,1543,1512,SMARCB1
chr22,24176235,24176416,CHP2_SMARCB1_4.1,1280,642,638,SMARCB1
