Chr,Start,Stop,Region,Coverage,CoverageRead1,CoverageRead2,GeneIDs
chr1,43814944,43815111,CHP2_MPL_1.1,633,327,306,MPL
chr1,115252161,115252294,CHP2_NRAS_3.1,3419,1722,1697,NRAS
chr1,115256480,115256609,CHP2_NRAS_2.1,1046,525,521,NRAS
chr1,115258665,115258799,CHP2_NRAS_1.1,1840,924,916,NRAS
chr2,29432548,29432705,CHP2_ALK_2.1,376,192,184,ALK
chr2,29443583,29443754,CHP2_ALK_1.1,643,324,319,ALK
chr2,209113079,209113231,CHP2_IDH1_1.1,1257,631,626,IDH1
chr2,212288880,212289015,CHP2_ERBB4_8.1,1766,887,879,ERBB4
chr2,212530027,212530205,CHP2_ERBB4_7.1,217,108,109,ERBB4
chr2,212576775,212576935,CHP2_ERBB4_6.1,1343,679,664,ERBB4
chr2,212578264,212578440,CHP2_ERBB4_5.1,860,439,421,ERBB4
chr2,212587109,212587264,CHP2_ERBB4_4.1,1098,554,544,ERBB4
chr2,212589740,212589892,CHP2_ERBB4_3.1,421,211,210,ERBB4
chr2,212652695,212652831,CHP2_ERBB4_2.1,1755,883,872,ERBB4
chr2,212812051,212812194,CHP2_ERBB4_1.1,652,328,324,ERBB4
chr3,10183741,10183879,CHP2_VHL_1.1,535,280,255,VHL
chr3,10188162,10188331,CHP2_VHL_2.1,1194,607,587,VHL
chr3,10191394,10191552,CHP2_VHL_3.1,2082,1051,1031,VHL
chr3,37067183,37067358,CHP2_MLH1_1.1,870,438,432,MLH1
chr3,41266005,41266172,CHP2_CTNNB1_1.1,425,215,210,CTNNB1
chr3,178916751,178916906,CHP2_PIK3CA_1.1,1264,633,631,PIK3CA
chr3,178916907,178917060,CHP2_PIK3CA_2.1,736,370,366,PIK3CA
chr3,178921440,178921595,CHP2_PIK3CA_3.1,1126,564,562,PIK3CA
chr3,178927381,178927550,CHP2_PIK3CA_4.1,603,305,298,PIK3CA
chr3,178927877,178928011,CHP2_PIK3CA_5.1,925,462,463,PIK3CA
chr3,178928045,178928185,CHP2_PIK3CA_6.1,1036,524,512,PIK3CA
chr3,178935999,178936130,CHP2_PIK3CA_7.1,2979,1498,1481,PIK3CA
chr3,178938763,178938943,CHP2_PIK3CA_8.1,620,314,306,PIK3CA
chr3,178947794,178947921,CHP2_PIK3CA_9.1,5163,2592,2571,PIK3CA
chr3,178951972,178952122,CHP2_PIK3CA_10.1,1366,686,680,PIK3CA
chr3,178952116,178952262,CHP2_PIK3CA_11.1,1870,938,932,PIK3CA
chr4,1803527,1803678,CHP2_FGFR3_1.1,1187,672,515,FGFR3
chr4,1806057,1806212,CHP2_FGFR3_2.1,408,212,196,FGFR3
chr4,1807809,1807955,CHP2_FGFR3_3.1,2199,1119,1080,FGFR3
chr4,1808287,1808424,CHP2_FGFR3_4.1,3040,1534,1506,FGFR3
chr4,1808857,1809031,CHP2_FGFR3_5.1,1926,978,948,FGFR3
chr4,55140957,55141128,CHP2_PDGFRA_1.1,456,230,226,PDGFRA
chr4,55144077,55144220,CHP2_PDGFRA_2.1,2355,1183,1172,PDGFRA
chr4,55144514,55144678,CHP2_PDGFRA_3.1,583,293,290,PDGFRA
chr4,55152000,55152179,CHP2_PDGFRA_4.1,1073,537,536,PDGFRA
chr4,55561630,55561809,CHP2_KIT_1.1,989,500,489,KIT
chr4,55592133,55592271,CHP2_KIT_2.1,2203,1108,1095,KIT
chr4,55593393,55593538,CHP2_KIT_3.1,1314,662,652,KIT
chr4,55593551,55593720,CHP2_KIT_4.1,991,496,495,KIT
chr4,55594146,55594304,CHP2_KIT_5.1,753,379,374,KIT
chr4,55595472,55595587,CHP2_KIT_6.1,3350,1685,1665,KIT
chr4,55597412,55597549,CHP2_KIT_7.1,1367,687,680,KIT
chr4,55599256,55599383,CHP2_KIT_8.1,2137,1071,1066,KIT
chr4,55602649,55602776,CHP2_KIT_9.1,2766,1390,1376,KIT
chr4,55946064,55946233,CHP2_KDR_9.1,354,179,175,KDR
chr4,55946226,55946396,CHP2_KDR_8.1,1262,636,626,KDR
chr4,55953751,55953885,CHP2_KDR_7.1,1738,876,862,KDR
chr4,55955054,55955193,CHP2_KDR_6.1,3479,1755,1724,KDR
chr4,55960952,55961084,CHP2_KDR_5.1,4429,2231,2198,KDR
chr4,55962420,55962573,CHP2_KDR_4.1,605,303,302,KDR
chr4,55972928,55973096,CHP2_KDR_3.1,372,186,186,KDR
chr4,55979550,55979680,CHP2_KDR_2.1,944,478,466,KDR
chr4,55980214,55980384,CHP2_KDR_1.1,639,321,318,KDR
chr4,153245386,153245517,CHP2_FBXW7_5.1,3538,1779,1759,FBXW7
chr4,153247253,153247394,CHP2_FBXW7_4.1,2302,1162,1140,FBXW7
chr4,153249331,153249502,CHP2_FBXW7_3.1,622,313,309,FBXW7
chr4,153250828,153250951,CHP2_FBXW7_2.1,2692,1352,1340,FBXW7
chr4,153258877,153259048,CHP2_FBXW7_1.1,544,275,269,FBXW7
chr5,112173847,112173987,CHP2_APC_1.1,2485,1254,1231,APC
chr5,112174533,112174691,CHP2_APC_2.1,1083,545,538,APC
chr5,112175119,112175293,CHP2_APC_3.1,773,389,384,APC
chr5,112175291,112175468,CHP2_APC_4.1,763,384,379,APC
chr5,112175543,112175728,CHP2_APC_5.1,448,225,223,APC
chr5,112175716,112175887,CHP2_APC_6.1,907,460,447,APC
chr5,112175896,112176060,CHP2_APC_7.1,367,185,182,APC
chr5,149433569,149433717,CHP2_CSF1R_2.1,453,230,223,CSF1R
chr5,149452967,149453098,CHP2_CSF1R_1.1,1096,552,544,CSF1R
chr5,170837477,170837641,CHP2_NPM1_1.1,1314,664,650,NPM1
chr7,55211020,55211151,CHP2_EGFR_1.1,1275,640,635,EGFR
chr7,55221768,55221944,CHP2_EGFR_2.1,601,307,294,EGFR
chr7,55232938,55233078,CHP2_EGFR_3.1,4167,2099,2068,EGFR
chr7,55241611,55241754,CHP2_EGFR_4.1,928,469,459,EGFR
chr7,55242387,55242565,CHP2_EGFR_5.1,541,276,265,EGFR
chr7,55248941,55249115,CHP2_EGFR_6.1,966,489,477,EGFR
chr7,55249098,55249270,CHP2_EGFR_7.1,870,439,431,EGFR
chr7,55259483,55259653,CHP2_EGFR_8.1,926,466,460,EGFR
chr7,116339591,116339726,CHP2_MET_1.1,2990,1504,1486,MET
chr7,116340131,116340295,CHP2_MET_2.1,826,416,410,MET
chr7,116403107,116403276,CHP2_MET_3.1,530,265,265,MET
chr7,116411854,116412022,CHP2_MET_4.1,942,475,467,MET
chr7,116417403,116417567,CHP2_MET_5.1,936,473,463,MET
chr7,116423383,116423517,CHP2_MET_6.1,1633,826,807,MET
chr7,128845039,128845213,CHP2_SMO_1.1,1766,889,877,SMO
chr7,128845933,128846088,CHP2_SMO_2.1,676,341,335,SMO
chr7,128846313,128846444,CHP2_SMO_3.1,1499,756,743,SMO
chr7,128850245,128850388,CHP2_SMO_4.1,969,490,479,SMO
chr7,128851475,128851637,CHP2_SMO_5.1,820,416,404,SMO
chr7,140453078,140453246,CHP2_BRAF_2.1,807,405,402,BRAF
chr7,140481367,140481540,CHP2_BRAF_1.1,1187,604,583,BRAF
chr7,148508682,148508816,CHP2_EZH2_1.1,2081,1044,1037,EZH2
chr8,38282116,38282279,CHP2_FGFR1_2.1,980,497,483,FGFR1
chr8,38285827,38286000,CHP2_FGFR1_1.1,305,152,153,FGFR1
chr9,5073705,5073882,CHP2_JAK2_1.1,549,275,274,JAK2
chr9,21970916,21971091,CHP2_CDKN2A_2.1,685,349,336,CDKN2A
chr9,21971066,21971244,CHP2_CDKN2A_1.1,545,306,239,CDKN2A
chr9,80409351,80409523,CHP2_GNAQ_1.1,597,302,295,GNAQ
chr9,133738270,133738403,CHP2_ABL1_1.1,5853,2950,2903,ABL1
chr9,133747418,133747555,CHP2_ABL1_2.1,2377,1196,1181,ABL1
chr9,133748255,133748442,CHP2_ABL1_3.1,620,312,308,ABL1
chr9,133750283,133750430,CHP2_ABL1_4.1,732,370,362,ABL1
chr9,139390740,139390910,CHP2_NOTCH1_3.1,919,466,453,NOTCH1
chr9,139397738,139397904,CHP2_NOTCH1_2.1,1759,890,869,NOTCH1
chr9,139399313,139399472,CHP2_NOTCH1_1.1,709,362,347,NOTCH1
chr10,43609042,43609207,CHP2_RET_1.1,1483,753,730,RET
chr10,43609850,43610035,CHP2_RET_2.1,910,460,450,RET
chr10,43613770,43613918,CHP2_RET_3.1,1609,816,793,RET
chr10,43615522,43615712,CHP2_RET_4.1,545,278,267,RET
chr10,43617290,43617458,CHP2_RET_5.1,644,323,321,RET
chr10,89624183,89624325,CHP2_PTEN_1.1,635,318,317,PTEN
chr10,89685234,89685399,CHP2_PTEN_2.1,945,478,467,PTEN
chr10,89692789,89692945,CHP2_PTEN_3.1,815,411,404,PTEN
chr10,89711780,89711957,CHP2_PTEN_4.1,465,234,231,PTEN
chr10,89717479,89717645,CHP2_PTEN_5.1,910,456,454,PTEN
chr10,89717642,89717805,CHP2_PTEN_6.1,857,434,423,PTEN
chr10,89720671,89720772,CHP2_PTEN_7.1,6890,3456,3434,PTEN
chr10,89720760,89720925,CHP2_PTEN_8.1,1238,623,615,PTEN
chr10,123257928,123258070,CHP2_FGFR2_4.1,1680,845,835,FGFR2
chr10,123274697,123274860,CHP2_FGFR2_3.1,296,148,148,FGFR2
chr10,123279393,123279569,CHP2_FGFR2_2.1,949,477,472,FGFR2
chr10,123279583,123279738,CHP2_FGFR2_1.1,1502,761,741,FGFR2
chr11,533788,533955,CHP2_HRAS_2.1,402,202,200,HRAS
chr11,534196,534333,CHP2_HRAS_1.1,659,339,320,HRAS
chr11,108117741,108117890,CHP2_ATM_1.1,823,414,409,ATM
chr11,108119791,108119916,CHP2_ATM_2.1,2924,1474,1450,ATM
chr11,108123491,108123643,CHP2_ATM_3.1,2178,1093,1085,ATM
chr11,108137907,108138050,CHP2_ATM_4.1,1151,578,573,ATM
chr11,108155059,108155205,CHP2_ATM_5.1,1176,593,583,ATM
chr11,108170432,108170581,CHP2_ATM_6.1,1082,547,535,ATM
chr11,108172338,108172492,CHP2_ATM_7.1,1976,993,983,ATM
chr11,108173606,108173728,CHP2_ATM_8.1,4398,2212,2186,ATM
chr11,108180878,108180985,CHP2_ATM_9.1,3302,1656,1646,ATM
chr11,108200891,108201018,CHP2_ATM_10.1,2367,1194,1173,ATM
chr11,108204610,108204709,CHP2_ATM_11.1,4681,2365,2316,ATM
chr11,108205707,108205841,CHP2_ATM_12.1,3113,1561,1552,ATM
chr11,108206499,108206653,CHP2_ATM_13.1,1323,667,656,ATM
chr11,108217991,108218169,CHP2_ATM_14.1,351,175,176,ATM
chr11,108225525,108225657,CHP2_ATM_15.1,1768,891,877,ATM
chr11,108236018,108236165,CHP2_ATM_16.1,1344,676,668,ATM
chr11,108236162,108236310,CHP2_ATM_17.1,736,370,366,ATM
chr12,25378525,25378683,CHP2_KRAS_3.1,944,473,471,KRAS
chr12,25380236,25380389,CHP2_KRAS_2.1,1341,673,668,KRAS
chr12,25398162,25398329,CHP2_KRAS_1.1,671,339,332,KRAS
chr12,112888094,112888253,CHP2_PTPN11_1.1,1022,516,506,PTPN11
chr12,112926811,112926986,CHP2_PTPN11_2.1,1029,517,512,PTPN11
chr12,121431347,121431484,CHP2_HNF1A_1.1,1572,795,777,HNF1A
chr12,121431986,121432124,CHP2_HNF1A_2.1,4306,2162,2144,HNF1A
chr13,28592555,28592688,CHP2_FLT3_4.1,1891,958,933,FLT3
chr13,28602251,28602404,CHP2_FLT3_3.1,1914,963,951,FLT3
chr13,28608203,28608373,CHP2_FLT3_2.1,654,328,326,FLT3
chr13,28610069,28610209,CHP2_FLT3_1.1,3105,1565,1540,FLT3
chr13,48919199,48919337,CHP2_RB1_1.1,1333,668,665,RB1
chr13,48923115,48923280,CHP2_RB1_2.1,601,301,300,RB1
chr13,48941577,48941749,CHP2_RB1_3.1,658,331,327,RB1
chr13,48942573,48942736,CHP2_RB1_4.1,615,313,302,RB1
chr13,48953729,48953899,CHP2_RB1_5.1,1135,575,560,RB1
chr13,48955501,48955630,CHP2_RB1_6.1,2730,1373,1357,RB1
chr13,49027081,49027203,CHP2_RB1_7.1,1684,851,833,RB1
chr13,49033803,49033959,CHP2_RB1_8.1,993,499,494,RB1
chr13,49037822,49037957,CHP2_RB1_9.1,1366,687,679,RB1
chr13,49039125,49039257,CHP2_RB1_10.1,2198,1107,1091,RB1
chr14,105241409,105241544,CHP2_AKT1_2.1,2100,1059,1041,AKT1
chr14,105246421,105246608,CHP2_AKT1_1.1,466,235,231,AKT1
chr15,90631800,90631979,CHP2_IDH2_1.1,933,469,464,IDH2
chr16,68835578,68835722,CHP2_CDH1_1.1,2354,1185,1169,CDH1
chr16,68846000,68846176,CHP2_CDH1_2.1,661,333,328,CDH1
chr16,68847175,68847327,CHP2_CDH1_3.1,1872,940,932,CDH1
chr17,7573899,7574060,CHP2_TP53_8.1,1381,696,685,TP53
chr17,7576991,7577176,CHP2_TP53_7.1,494,248,246,TP53
chr17,7577484,7577637,CHP2_TP53_6.1,1409,711,698,TP53
chr17,7578156,7578323,CHP2_TP53_5.1,666,337,329,TP53
chr17,7578328,7578508,CHP2_TP53_4.1,1596,805,791,TP53
chr17,7578492,7578626,CHP2_TP53_3.1,2246,1129,1117,TP53
chr17,7579326,7579510,CHP2_TP53_2.1,756,394,362,TP53
chr17,7579829,7579985,CHP2_TP53_1.1,1711,861,850,TP53
chr17,37880188,37880365,CHP2_ERBB2_1.1,878,442,436,ERBB2
chr17,37880929,37881086,CHP2_ERBB2_2.1,1189,594,595,ERBB2
chr17,37881300,37881478,CHP2_ERBB2_3.1,731,379,352,ERBB2
chr18,48575075,48575238,CHP2_SMAD4_1.1,1067,535,532,SMAD4
chr18,48575532,48575702,CHP2_SMAD4_2.1,435,220,215,SMAD4
chr18,48581166,48581327,CHP2_SMAD4_3.1,813,411,402,SMAD4
chr18,48584527,48584703,CHP2_SMAD4_4.1,667,334,333,SMAD4
chr18,48586227,48586386,CHP2_SMAD4_5.1,890,447,443,SMAD4
chr18,48591790,48591956,CHP2_SMAD4_6.1,993,501,492,SMAD4
chr18,48593375,48593544,CHP2_SMAD4_7.1,681,345,336,SMAD4
chr18,48603004,48603144,CHP2_SMAD4_8.1,3757,1902,1855,SMAD4
chr18,48604634,48604799,CHP2_SMAD4_9.1,770,389,381,SMAD4
chr19,1206953,1207129,CHP2_STK11_1.1,1146,584,562,STK11
chr19,1220286,1220475,CHP2_STK11_2.1,291,149,142,STK11
chr19,1220456,1220628,CHP2_STK11_3.1,1497,848,649,STK11
chr19,1221212,1221357,CHP2_STK11_4.1,2492,1250,1242,STK11
chr19,1222990,1223169,CHP2_STK11_5.1,1287,651,636,STK11
chr19,3118857,3118998,CHP2_GNA11_1.1,1546,786,760,GNA11
chr19,17945592,17945759,CHP2_JAK3_3.1,1299,659,640,JAK3
chr19,17947962,17948099,CHP2_JAK3_2.1,1897,953,944,JAK3
chr19,17954110,17954250,CHP2_JAK3_1.1,2356,1191,1165,JAK3
chr20,36031642,36031794,CHP2_SRC_1.1,3502,1769,1733,SRC
chr20,57484372,57484529,CHP2_GNAS_1.1,509,260,249,GNAS
chr20,57484538,57484697,CHP2_GNAS_2.1,2196,1103,1093,GNAS
chr22,24133929,24134089,CHP2_SMARCB1_1.1,1059,534,525,SMARCB1
chr22,24143176,24143336,CHP2_SMARCB1_2.1,300,151,149,SMARCB1
chr22,24145453,24145623,CHP2_SMARCB1_3.1,1137,579,558,SMARCB1
chr22,24176235,24176416,CHP2_SMARCB1_4.1,602,303,299,SMARCB1
